4,2,0
103,4,0,0,0,0,4,103
103,0,102,0,0,101,102,101
103,0,102,0,0,0,0,101
102,2,103,0,0,103,0,2
102,0,2,0,0,103,2,2
0,0,0,0,0,0,0,101
0,0,103,103,103,103,0,0
0,5,103,3,3,103,0,0