3,4,1
4,4,0,0,0,0,4,4
0,0,102,102,102,101,0,0
102,0,0,0,0,0,0,102
103,0,2,103,103,2,0,103
102,0,0,0,0,0,0,102
0,0,0,0,0,0,0,0
0,0,103,103,103,103,0,0
0,5,103,3,3,103,0,0