3,2,4
0,4,0,0,0,0,4,0
103,0,0,102,102,0,0,103
0,102,0,0,0,0,102,0
0,0,101,0,0,101,0,0
0,2,2,0,0,2,2,0
0,0,0,0,0,0,0,0
0,0,103,103,103,103,0,0
0,5,103,3,3,103,0,0