0,2,6
0,4,0,103,103,0,4,0
4,0,0,0,0,0,0,4
0,2,103,2,102,2,0,2
102,102,0,0,103,0,0,103
2,0,0,2,101,0,2,103
0,0,0,5,0,0,0,0
0,0,103,103,103,103,0,0
0,0,103,3,3,103,0,0