4,4,4
0,4,0,0,0,0,4,0
0,101,0,0,0,0,101,0
102,102,102,0,0,102,102,102
102,0,0,103,103,0,0,102
101,2,2,0,0,2,2,101
0,0,0,0,0,0,0,0
0,0,103,103,103,103,0,0
0,5,103,3,3,103,0,0